
NO textures/north_texture.xpm

SO textures/south_texture.xpm

WE textures/west_texture.xpm

EA textures/east_texture.xpm

F 220,100,0
C 225,30,0

        1111111111111111111111111111
        1N0000000011110000000000001
        101100000111110000000000001
        100100000001100000000000001
11111111101100000111110000000000001
10000000001100000111110111111111111
1111011111111101110110000010001
1111011111111101110111010010001
1100000011010101110110000010001
1000000000000000110110000010001
1000000000000000110111010010001
11000001110101011111110111100111
11110111 1110101 10111111010001
11111111 1111111 111111111111111

