NO textures/north_texture.xpm
SO textures/south_texture.xpm
WE textures/west_texture.xpm
EA textures/east_texture.xpm

F 22,150,23
C 225,30,1

11111111111111111 1  
         111                          11111111
111111111111111111     11111111111111111111101
100000000011000001     100000101           11111          
111111111111111111     111111111
111111111111111111     111111111
101100000111000001     10000001
10010000000000N001     10000001
111111111111111111     11111111
111111111111111111     111111111111111
111111111011000001     110000000000001
100000000011000001     110111111111111
111101111111110111    1100000010001
11110111111111011     1010100100011
11000000110101011     100000010001
10000000000000001     1000000100011
10000001000000001     1011100100011
11000000101010111     101111001111
1111111111111111      1011110100011
11111111111111111     1111111111111
