NO     textures/north_texture.xpm
SO textures/south_texture.xpm
C 11,30,4
F 12,30,0
WE textures/west_texture.xpm
EA textures/east_texture.xpm

        1111111111111111111111111
        1000000000110000000000001100001
        1011000001110000000000001
        10010000000000000000000 1
111111111011000001110000000000001
100000000011000001110111111111111
111111111111111111111111111111111
    1         1   111111 111
11110111111111011100000010001
11110111111111011101010010001
11000000110101011100000010001
10000000000000001100000010001
10000000000000001101010010001
11000001110101011111011110E0111
11110111 1110101 101111010001
11111111 1111111 111111111111
