NO  textures/north_texture.xpm
SO textures/south_texture.xpm
WE textures/west_texture.xpm
EA textures/east_texture.xpm

F 220,100,0
C 225,30,0



        1111111111111111111                    111         
        111011111111111111111111111111111111111101
        10000000001100000000000101             111          
        11111111111111111111111111
        1111111111111111111111111
        1011000001110000000000001
        1001000000000000000000001
111111111011000001110000000000001
100000000011000001110111111111111
11110111111111011100000010001
11110111111111011101010010001
11000000110101011100000010001
10000000000000001100000010001
10000000000000011011100100011
1100000N110101011111011110011
1111010111110101 101111010001
11111111 1111111 111111111111
  
   
    
     
      
       





